// $at
0000_0001
// $v0-$v1
0000_0002
0000_0003
// $a0-$a3
0000_0004
0000_0005
0000_0006
0000_0007
// $t0-$t7
0000_0001
0000_0002
0000_0003
0000_0004
0000_0005
0000_0006
0000_0007
0000_0008
// $s0-$s7
0000_0001
0000_0002
0000_0003
0000_0004
0000_0005
0000_0006
0000_0007
0000_0008
// $t8-$t9
0000_0024
0000_0025
// $k0-$k1
0000_0026
0000_0027
// $gp
0000_0028
// $sp
0000_0029
// $fp
0000_0030
// $ra
0000_0031


